000000000000000000000000000000000000000000
054111104440111111111111111111111111044430
011111104440111111111111111111111111104440
011111110301111111144111111111111111110440
011222222401111111113441111111111111111040
011220001011111112221111111111111111122210
011221110111111111122211111111111111200020
031222222222222222222111111111111112222220
011111111111111111111111111112221122222220
000000000000000000000000000000001222222220
011111111111111111111111111111111222222200
011100111111112222222222222222222222222000
011032011111111111111111111111111222220000
011104201100000000000000000000000000020000
011110420144311111111111111111111111131110
011111040100411111222211111111111111111110
011111040101111112222222111111112222211110
011111111111111112222222111111112222211190
022211121111221111122221111111112222111110
022221121111111111117111111111117221111110
012322121111111111111111111111111111111110
000000000000000000000000000000000000000000