000000000000000000000000000000000000000000
052201111111111111111111000000001111111110
022200000000000000000000222222230111111110
022231111111111111111111222222230111111110
000000000000000000000000722222230111111110
011111111111111111111111001000001111111110
011111141111111111111111101011111111111110
011111434111111111111111101011111111111110
011111141111111111111111101011111111111110
011111111111111111100011001001111111111110
011111111111111100044400311110111111111110
011111111111111122211122311110111111111110
011111111111111100022200311110111111111110
011111111111111111122211000001111111111110
011111111111111111122211111111111111111110
011111111111111111122211111111111111222220
011111111111111111111111111111111111222220
011111111111111111122211111111111111222290
011111111111111111172211111111111111222220
011111111111111111172211111111111111222220
011111111111111111111111111111111111111110
000000000000000000000000000000000000000000