000000000000000000000000000000000000000000
051111111443441111111111111111111111111110
011111111111111111111111111111111111111110
000000000000000000000000000000000000003000
022222222222222222222222222222222222211120
072222222222222222222222222222222222222220
003000000000000000000000000000000000000000
011444444444444444444444444444444444441110
011111111111111111111111111111111111111110
000000000000000000000000000000000000000300
022222222222222222222222222222222222211120
022222222222222222222222222222222222211120
003000000000000000000000000000000000000000
011111111111111111111111111111111111111110
011111111111111111111111111111111111111110
000000000000000000000000000000000000003000
022222222222222222222222222222222222211120
072222222222222222222222222222222222222220
003000000000000000000000000000000000000000
011111111111111111111111111111111111229220
011111111111111111111111111111111111222220
000000000000000000000000000000000000000000