000000000000000000000000000000000000000000
052222211111222222200222222222222222201310
022222211411222222200222222222222222201110
022222214341222222200222222222222222222220
022222211411222222200222222222222222222220
022222211111222222200222222222222222222220
022222222222222222200222222222222222222220
022222222222222222200222222222222222222220
022222222222222222211222222222222222222220
072222222222222222711722222222222222222270
000000000000000011133111100000000000000000
022222222222222222211222204444444444013310
022222222222222222211222201111111111011110
022222222222222222200222222222222222222220
022222222222222222200222222222222222222220
022222292222222222200222222222222222222220
022222222222222222200222222222222222222220
022222222222222222200222222222222222222220
022222222222222222200222222222222222222220
022222222222222222200222222222222222222220
072222223222222222722722222222222222222270
000000000000000000000000000000000000000000