000000000000000000000000000000000000000000
011111111111111111111111111111111111141110
011111111111111111111111111111111111131110
011111112211111111113111111111111111111110
011111227222151111111111111111111111111110
011111112211111111111111111111111111111110
011111111111111111111111111111131111111110
011111111111111111111111111111149111111110
011111111131111111111411111111111114111110
011111111111111111111111111111111111111110
011111111111111111111111111111111111111110
011111111111111111111111111111111111111110
011111111111111111111111111111111111311110
011111111141111311111111111111111111111110
011111111111111111111111111111111111111110
011111111111111111111111111111111111111110
011111111111111111111111111111111111111110
011111131111111111111111111111111111111110
011111111111111111113431111113111111111110
01111111111111111111163111111111111111110
011111111111111111114131111111111111111110
000000000000000000000000000000000000000000